11 11
S#.#...##.G
..##..#..#.
.#..#.#....
...##..#...
..#.....###
#...#...#..
..#..#.#.#.
.####.....#
..###.##...
.#....####.
###........